111111111111111
1E0C0000C0000C1
100000C0000P001
111111111111111
1000000C0100001
1000C0001C100C1
100000000100001
111111111111111