1111111111111
1000000000001
100001E10C111
1111111111111