1111111111111
100E000000001
100001E10C111
1111111111111